1111111111
1000000001
1P0000ECC1
10000CCCC1
1111000001
1110000111
1111111111