11111111111111111111111111111111111
1000000000000C000000011111000000001
1C011111C001111000000000000111C0001
11111100000000000C00000C01111110001
10000001111111110011111111CCC000001
111110000000111001111C0000100001111
1111110000000000C000E111100000P0001
11110000C00000P111111111C0001111111
1111111100000001111100000C000000001
1E00000000000000C0000000111110C0001
1111C110000C11111111111111100000001
11111111111111111111111111111111111